who was the trump ocean club international hotel and tower named after	O O O I I I I I I I O O	O O O I I I I I I I O O
where was sasha vujačić born <pad> <pad> <pad> <pad> <pad> <pad> <pad>	O O I I O <pad> <pad> <pad> <pad> <pad> <pad> <pad>	O O I I O <pad> <pad> <pad> <pad> <pad> <pad> <pad>
what is a region that dead combo was released in <pad> <pad>	O O O O O I I O O O <pad> <pad>	O O O O O I I O O O <pad> <pad>
what is a film directed by wiebke von carolsfeld ? <pad> <pad>	O O O O O O I I I O <pad> <pad>	O O O O O O I I I O <pad> <pad>
what country was music for stock exchange released in <pad> <pad> <pad>	O O O I I I I O O <pad> <pad> <pad>	O O O I I I I O O <pad> <pad> <pad>
where is adler school of professional psychology located ? <pad> <pad> <pad>	O O I I I I I O O <pad> <pad> <pad>	O O I I I I I O O <pad> <pad> <pad>
where was john miltern born <pad> <pad> <pad> <pad> <pad> <pad> <pad>	O O I I O <pad> <pad> <pad> <pad> <pad> <pad> <pad>	O O I I O <pad> <pad> <pad> <pad> <pad> <pad> <pad>
what city is vancouver millionaires from ? <pad> <pad> <pad> <pad> <pad>	O O O I I O O <pad> <pad> <pad> <pad> <pad>	O O O I I O O <pad> <pad> <pad> <pad> <pad>
what was seymour parker gilbert 's profession ? <pad> <pad> <pad> <pad>	O O I I I O O O <pad> <pad> <pad> <pad>	O O I I I O O O <pad> <pad> <pad> <pad>
what does ( 12385 ) 1994 uo orbit <pad> <pad> <pad> <pad>	O O I I I I I O <pad> <pad> <pad> <pad>	O O I I I I I O <pad> <pad> <pad> <pad>
who is the singer of only women bleed <pad> <pad> <pad> <pad>	O O O O O I I I <pad> <pad> <pad> <pad>	O O O O O I I I <pad> <pad> <pad> <pad>
in what french city did antoine de févin die <pad> <pad> <pad>	O O O O O I I I O <pad> <pad> <pad>	O O O O O I I I O <pad> <pad> <pad>
who published rama <pad> <pad> <pad> <pad> <pad> <pad> <pad> <pad> <pad>	O O I <pad> <pad> <pad> <pad> <pad> <pad> <pad> <pad> <pad>	O O I <pad> <pad> <pad> <pad> <pad> <pad> <pad> <pad> <pad>
who was an advisor for irving langmuir ? <pad> <pad> <pad> <pad>	O O O O O I I O <pad> <pad> <pad> <pad>	O O O O O I I O <pad> <pad> <pad> <pad>
what is the language of the film bon voyage ? <pad> <pad>	O O O O O O O I I O <pad> <pad>	O O O O O O O I I O <pad> <pad>
which country was the hunyadi family from <pad> <pad> <pad> <pad> <pad>	O O O I I I O <pad> <pad> <pad> <pad> <pad>	O O O O I I O <pad> <pad> <pad> <pad> <pad>
what major cities does u.s. route 2 run through <pad> <pad> <pad>	O O O O I I I O O <pad> <pad> <pad>	O O O O I I I O O <pad> <pad> <pad>
who was a child of mithibai jinnah <pad> <pad> <pad> <pad> <pad>	O O O O O I I <pad> <pad> <pad> <pad> <pad>	O O O O O I I <pad> <pad> <pad> <pad> <pad>
whats a version of the single titled star <pad> <pad> <pad> <pad>	O O O O O O O I <pad> <pad> <pad> <pad>	O O O O O O O I <pad> <pad> <pad> <pad>
what is a song by john rutter ? <pad> <pad> <pad> <pad>	O O O O O I I O <pad> <pad> <pad> <pad>	O O O O O I I O <pad> <pad> <pad> <pad>
what job does jamie hewlett have <pad> <pad> <pad> <pad> <pad> <pad>	O O O I I O <pad> <pad> <pad> <pad> <pad> <pad>	O O O I I O <pad> <pad> <pad> <pad> <pad> <pad>
what 's an example of an album <pad> <pad> <pad> <pad> <pad>	O O O O O O I <pad> <pad> <pad> <pad> <pad>	O O O O O O I <pad> <pad> <pad> <pad> <pad>
what is the film tempo di uccidere about <pad> <pad> <pad> <pad>	O O O O I I I O <pad> <pad> <pad> <pad>	O O O O I I I O <pad> <pad> <pad> <pad>
what country is ghost house from <pad> <pad> <pad> <pad> <pad> <pad>	O O O I I O <pad> <pad> <pad> <pad> <pad> <pad>	O O O I I O <pad> <pad> <pad> <pad> <pad> <pad>
which country was the yamakinkarudu movie produced <pad> <pad> <pad> <pad> <pad>	O O O O I O O <pad> <pad> <pad> <pad> <pad>	O O O O I O O <pad> <pad> <pad> <pad> <pad>
what 's the time zone in sub-saharan africa <pad> <pad> <pad> <pad>	O O O O O O I I <pad> <pad> <pad> <pad>	O O O O O O I I <pad> <pad> <pad> <pad>
what author wrote the book liquor ? <pad> <pad> <pad> <pad> <pad>	O O O O O I O <pad> <pad> <pad> <pad> <pad>	O O O O O I O <pad> <pad> <pad> <pad> <pad>
what is the release type of the album wake ? <pad> <pad>	O O O O O O O O I O <pad> <pad>	O O O O O O O O I O <pad> <pad>
who is the chid of fritz leiber ? <pad> <pad> <pad> <pad>	O O O O O I I O <pad> <pad> <pad> <pad>	O O O O O I I O <pad> <pad> <pad> <pad>
what artist creates riot grrrl music <pad> <pad> <pad> <pad> <pad> <pad>	O O O I I O <pad> <pad> <pad> <pad> <pad> <pad>	O O O I I O <pad> <pad> <pad> <pad> <pad> <pad>
what country is rafael sorkin from <pad> <pad> <pad> <pad> <pad> <pad>	O O O I I O <pad> <pad> <pad> <pad> <pad> <pad>	O O O I I O <pad> <pad> <pad> <pad> <pad> <pad>
what was marcy rae 's profession ? <pad> <pad> <pad> <pad> <pad>	O O I I O O O <pad> <pad> <pad> <pad> <pad>	O O I I O O O <pad> <pad> <pad> <pad> <pad>
